科室列表	dataq/api/page/getSendDeptList
输入法自动完成-表头	dataq/api/header
输入法自动完成-列表数据	dataq/api/page
字典	api/outilsTree1
住院汇总清单综合查询-病人列表	dataq/api/page/getPatientList4InHospSummary
导航and权限控制	api/commonMenu
导航菜单	api/routerMenu
获取门诊票据序号	api/deposit/getPaperNo
作废项目	api/deposit/updateUnpaidItem
全部作废	api/deposit/updateAllUnpaidItem
获取担保信息	api/deposit/getAssureOrArrears
新增担保人	api/deposit/addAssureOrArrears
取消担保	api/deposit/cancleAssureOrArrears
担保欠费设置	api/deposit/saveAssureSetting
获取openId	user/openId
发送短信验证码	sms/code
登录接口	api/login
获取医生信息	api/userInfo
账户列表	v1.0/sysUser/getSysUserList
查询关联医生列表	v1.0/sysUser/getRelevanceDoctorList
关联医生	v1.0/sysUser/getRelevanceDoctorList
取消关联医生	v1.0/sysUser/cancelRelevanceDoctor
根据角色ID获取菜单列表	v1.0/sysRole/getSysRoleMenuListByRoleId
获取医生列表	v1.0/sysRole/getSysDoctorList
上传医生头像	v1.0/sysRole/uploadDoctorImg
修改医生信息	v1.0/sysRole/updateSysDoctor
结算发票信息列表	dataq/api/page/getSettBillListForMZBRFPZHCL
结算信息列表	dataq/api/page/getSettIinforListForMZBRFPZHCL
已收费医技单	dataq/api/page/patientCostCorrectionGetSFYJYWList
待审批的医技项目	dataq/api/page/patientCostCorrectionGetYJYW00List
已收费医技单-医技计价明细	dataq/api/page/patientCostCorrectionGetSFYJJJList
待审批的药品处方	dataq/api/page/patientCostCorrectionGetCXCFH0List
处方明细	dataq/api/page/patientCostCorrectionGetCXCFMXList
未结算的直接收费项目	dataq/api/page/patientCostCorrectionGetTFFYMXList
获取系统名称字典	dataq/api/dict
医保场景列表数据获取	dataq/api/page/getYbSceneList
医保接口字段查询	dataq/api/page/getYbSceneList
拦截器递归请求	api/recursionajax
表格列表表头数据	dataq/api/header/getApproveArrearageList
表格列表内容数据	dataq/api/page/getApproveArrearageList
获取用户信息	user/info
表格列表表头数据带操作	dataq/api/header/getApproveArrearageListAction
列表数据自定义行背景色	dataq/api/page/stripe
获取病历号	api/medicalCard/getBLH000
门诊病人费别修改	api/medicalCard/editPayType
补卡换卡挂失恢复 卡操作	api/medicalCard/doCardOperate
失效卡回收	api/medicalCard/recInvalidCard
院内作废卡（失效卡）回收	api/medicalCard/recHospInvalidCard
回收写卡	api/medicalCard/recWriteCard
院外卡登记入库	api/medicalCard/regOutHospCard
补收病历本费	api/medicalCard/rechargeMedFee
退还病历本费	api/medicalCard/refundMedFee
缴款结算	api/settleAccount/payAndSettle
结账确认	api/settleAccount/settleConfirm
取消结账	api/settleAccount/settleCancel
取消确认	api/settleAccount/cancelConfirm
打印门诊病历首页	api/medicalCard/printMZSF_MZBL
查询病人信息	dataq/api/page/queryPatientList
查询已扣费记录	dataq/api/page/qryHaveDeduction
查询未扣费记录	dataq/api/page/qryNoDeduction
查询就诊卡信息	api/medicalCard/qryMedicalCardList
查询卡操作记录	dataq/api/page/qryMedCardRecords
查询病历本费信息	dataq/api/page/qryBookFeeList
查询收费员收费记录	dataq/api/page/qryCharges
查询结账发票	dataq/api/page/qryCheckInvoice
查询结账预交金	dataq/api/page/qryCheckAdvance
查询发票明细	dataq/api/page/qryInvoiceDetails
查询预交金明细	dataq/api/page/qryAdvanceDetails
查询换卡明细	dataq/api/page/qryChangeCardDetails
查询退费明细	dataq/api/page/qryRefundDetails
查询农保明细	dataq/api/page/qryAgrInsurDetails
关系符字典	dataq/api/dict/relation
运算符字典	dataq/api/dict/operation
查询条件	dataq/api/search
通用字典查询	dataq/api/dict
门诊病人通用读卡	commom/web/readPatientCard
获取账户信息	api/account/getAccountInfo
1.获取清账退卡信息（修改直接调用此api）	api/account/patientAccountDeal
门诊预交金缴费/退费	api/deposit/saveMzAdvancePay
获取门诊病人交款明细（点击交款信息按钮）	dataq/api/page/outpatPayDetails
未扣费明细-挂号记录查询	dataq/api/page/getRegisteredRecord
门诊收费-未扣费明细查询	dataq/api/page/getOutUnpaidDetail
获取职业字典	dataq/api/page/getInHosOccupationDictList
获取地市字典列表	dataq/api/page/getInHosCityDictList
获取区县字典列表	dataq/api/page/getInHosAreaDictList
获取单位字典名称	dataq/api/page/getInHosCompanyDictList
通用字典配置	dataq/api/xdict
动态字典	dataq/api/xdict
查询就诊卡信息	dataq/api/page/qryCard
查询病人信息	dataq/api/page/qryPatient
查询就诊卡业务	dataq/api/page/qryCardRecords
获取投保类别字典	dataq/api/page/getInsureSortDictList
获取地域范围字典	dataq/api/page/getAreaRange
预交金退款获取默认退款金额	api/deposit/doSetTKDefaultJFJE00
读卡器获取病人信息	commom/web/readPatientCard
门诊通用读卡	commom/web/readPatientCard
静态字典全部	cache/getUpdateDict
表名列表	configTable/querypage
新增路由	api/addRouter
门诊病人建卡登记	api/medicalCard/buy
获取民族字典列表	dataq/api/page/getInHosNationDictList
静态字典更新	cache/getUpdateDict/update
出院结算精准扶贫病人列表	dataq/api/page/getOutHospSettlForJzfpBrList
病人基本信息修改	api/medicalCard/editPatientInfo
动态字典dict	dataq/api/dict
扶贫病种操作 	api/inHosp//handlePoveAllevDisea
票据领用查询	dataq/api/page/queryBillList
显示票据使用情况	dataq/api/page/queryBillDetailsList
票据启用或停用	api/invoiceManage/billStatus
门诊票据增删改	api/invoiceManage/newBill
获取村委字典列表	dataq/api/page/getInHosVillageDictList
获取缴款单序号	api/settleAccount/getPayBillNo
出生日期转年龄	api/medicalCard/getBirthToAge
打印门诊病历首页	print/api/query/printMZSF_MZBL
打印门诊结账单	print/api/query/printMZSF_JZD
获取医院结算银行参数	api/medicalCard/getYYJSYHData
获取门诊建档界面初始化和系统参数	api/medicalCard/getInitAndSysData
缴款预览	api/settleAccount/payAndPreview
获取精准扶贫病种字典	dataq/api/page/getPoveAllevDiseaDictList
引擎DEMO1_1	api/odctest/odcTestOne1
获取新医保参数	api/medicalCard/getNewYBCS
获取建档前医保资格信息查询入参	api/medicalCard/getBuyCardYBReqParam
获取建档前医保资格信息查询出参	api/medicalCard/getBuyCardYBResParam
病区科室	dataq/api/wardDepartment
打印变更单	print/api/query/printMZSF_BGD
查询统一支付平台操作日志	dataq/api/page/getUnifiedPayOperLogList4mz
查询日志明细项列表	dataq/api/page/getUnifiedPayLogDetailList
打印门诊缴款明细	print/api/query/printMZSF_JKMX
导出结账发票	dataq/export/qryCheckInvoice
导出结账预交金	dataq/export/qryCheckAdvance
导出发票明细	dataq/export/qryInvoiceDetails
导出预交金明细	dataq/export/qryAdvanceDetails
导出换卡明细	dataq/export/qryChangeCardDetails
导出退费明细	dataq/export/qryRefundDetails
关联模块demo	relation/moduleid/demo
病案首页界面数据	dataq/api/page/medicalRecordHomePageList
审核确认	api/deposit/reviewSave
aaaaaaaaaa	fffffffffffffffffffffffff
切换账户类别刷新账户信息	api/deposit/reloadAccount
获取投保类别字典	api/medicalCard/getInsureSort
获取收费员字典列表	dataq/api/page/getTollDictList
获取员工字典列表	dataq/api/page/getEmployeeDictList
统一支付退预交金（微信支付宝原路退）	api/deposit/exeMzYJJPAYTK
2.统一支付清账退款	api/account/exeMzAccountYJJPAY
查询诊疗卡领用情况	dataq/api/page/queryDatcard
查询诊疗卡领用收费员身份详细情况	dataq/api/page/queryDatCardList
查询诊疗卡领用仓库身份详细情况	dataq/api/page/queryDatCardLists
作废票据序号-票据类型非0	api/deposit/getPaperNo
作废票据序号-票据类型编号为0	api/invoiceManage/receiptType
作废票据	api/invoiceManage/voidedBill
核算项目次序设置	api/AccountingSequence/queryAccSeq
查询核算项目	dataq/api/page/queryBAProjectOrder
 4.账户修改，清账，退卡院内	api/account/modifyAccount
医保卡更换	api/medicalCard/changeMediCareCard
获取病区科室树	api/web/depttree/getPatientTreeArea
查询住院病人列表	dataq/api/page/qryInHospPatientList
导出住院病人列表	dataq/export/qryInHospPatientList
查询出院院病人列表	api/page/qryOutHospPatientList
导出出院病人列表	dataq/export/qryOutHospPatientList
导出卡操作记录	dataq/export/qryMedCardRecords
病人费用更正处理主数据	dataq/api/page/patientCostCorrectionMainList
获取用户信息	getUserInfo
获取病人门诊预交金票据信息	dataq/api/page/getOutpatientYjjPjxx
待审批的医技项目-医技计价明细	dataq/api/page/patientCostCorrectionGetYJJJ00List
预交金电子凭证信息	dataq/api/page/queryVoucherInfo
获取开票点凭证库存数量	boSiVoucher/getStockNumByPlaceCode
病人列表表头数据	dataq/api/header/getInHospPatientList
病人列表页面数据	dataq/api/page/getInHospPatientList
开具电子凭证(单个补开共用)	api/boSiVoucher/draw
批量补开电子凭证	boSiVoucher/batchDraw
获取是否精准扶贫	api/medicalCard/getSFJZFP
打印院内预交金&&电子凭证 （共用）	boSiVoucher/print
门诊费用免收处理病人信息查询	dataq/api/page/qryOutFeePatientInformation
门诊费用免收处理	dataq/api/page/qryOutpatientFeeExemption
 门诊收费分项目减免、优惠处理	api/OutpatientProcessing/outRedandPre
门诊费用按总金额减免、优惠处理	api/OutpatientProcessing/outTotamountRed
门诊费用免收处理总额减免功能	dataq/api/page/qryOutTotalDeduction
门诊费用免收处理减免标志非0金额统计	dataq/api/page/qryOutNonzeroAmountStatistics
门诊费用免收处理减免标志为0金额统计	dataq/api/page/qryOutIsZeroAmountStatistics
分院数据字典	dataq/api/page/getHospBranchDictList
结算收据信息列表	dataq/api/page/getSettReceiptListForMZBRFPZHCL
结算费用明细	dataq/api/page/getPayDetailListForMZBRFPZHCL
读卡	commom/web/readPatientCard
获取票据号	api/billComp/getFpxh
获取套餐预收费记录	dataq/api/page/packagePreChargeRecord
实名认证	api/medicalCard/certification
获取套餐明细	dataq/api/page/getPackageDetails
表格组件过滤模板	dataq/filter/find/getInHospPatientList4cy
确定预收费	api/settle/confirmPrecharge
获取系统列表	system/listSystem
获取数据源配置	api/getDataSource
门诊费用退费确认病人信息	dataq/api/page/qryRefundPatientInformation
门诊费用退费确认项目	dataq/api/page/qryRefundConfirmationItems
套餐退款	api/settle/confirmPackageRefund
门诊费用退费项目详情	dataq/api/page/qryDetailsRefundItems
门诊费用确认退费	api/OutpatientProcessing/outRefundCon
姓名下拉字典	dataq/api/page/getMzBillPatientNameDictList
保存系统	system/saveSystem
删除系统	system/removeSystem
更新系统	system/updateSystem
变更审批	api/medicalCard/approve
获取按钮是否可编辑列表	api/billComp/getBtnEnableList
表格组件过滤模板-保存	dataq/filter/save/getInHospPatientList4cy
表格组件过滤模板-删除	dataq/filter/delete/getInHospPatientList4cy
发票重置	api/billComp/billReset
发票补打	api/billComp/billSupplePrint
获取病人信息	api/medicalCard/getPatientInfo
发票作废	api/billComp/billToVoid
查询数据源	database/listDatabase
保存数据源	database/saveDatabase
更新数据源	database/updateDatabase
删除数据源	database/removeDatabase
数据源校验	database/verifyDatabase
解析异地社保卡或二代证	api/medicalCard/parseRemoteCardOrId
发票打印	api/billComp/billPrint
发票复打	api/billComp/billRepeatPrint
门诊结算读卡	api/settlePage/qrySettle
校验发票打印可以操作 结账单号	api/billComp/checkJzdhForBillPrint
登录	login
收据补打	api/billComp/patchReceiptPrint
收据转发票	api/billComp/changeReceipt2Bill
打印退卡说明	print/api/query/printMZSF_TKSM
查询门诊明细清单	dataq/api/page/qryOutpatientList
打印门诊清单	print/api/query/printZsfptFPRQD
打印门诊汇总清单	print/api/query/printZsfptRQDHZ
打印门诊明细单行	print/api/query/printMzsFptZTRQD
打印门诊医保清单	print/api/query/printZsffptFPRQDYBGS
查询系统名称&ID	system/listSysName
查询路由	route/listRoute
保存路由	route/saveRoute
删除路由	route/removeRoute
更新路由	route/updateRoute
动态获取数据库表	database/listTables
查询数据源名称&ID	database/listDbName
取药凭证信息	api/billComp/getReceiptMediInfo
门诊病人综合查询-基本信息	dataq/api/page/ComprehensiveInquiryofPatients
门诊病人综合查询-病人查找	dataq/api/page/ComprehensiveFindPatient
门诊病人综合查询-账户信息	dataq/api/page/ComprehensiveAccountInformation
门诊病人综合查询-预交金信息	dataq/api/page/ComprehensiveAdvancePayment
门诊病人综合查询-支付明细记录	dataq/api/page/ComprehensivePaymentDetails
门诊病人综合查询-支付明细单条记录	dataq/api/page/ComprehensiveSingleDetails
门诊病人综合查询-未结算费用	dataq/api/page/ComprehensiveUnsettledExpenses
门诊病人综合查询-结算记录	dataq/api/page/ComprehensiveSettlementRecord
门诊病人综合查询-结算明细一	dataq/api/page/ComprehensiveSettlementDetailsOne
门诊病人综合查询-结算明细二	dataq/api/page/ComprehensiveSettlementDetailsTwo
门诊病人综合查询-票据信息	dataq/api/page/ComprehensiveBillInformation
 门诊病人综合查询-挂号信息	dataq/api/page/ComprehensiveRegistrationInformation
门诊病人综合查询-诊断信息	dataq/api/page/ComprehensiveDiagnosticInformation
 门诊病人综合查询-费用明细信息	dataq/api/page/ComprehensiveExpenseDetails
门诊病人综合查询-费用汇总信息	dataq/api/page/ComprehensiveCostAggregation
门诊病人综合查询-费别转换记录	dataq/api/page/ComprehensiveFeeConversion
 门诊病人综合查询-退费信息	dataq/api/page/ComprehensiveRefundInformation
门诊病人综合查询-待记账信息	dataq/api/page/ComprehensiveTobeBookkept
查询药房取药排队队列列表	dataq/api/page/getPharmPickUpLineQueueList
查询预交金支付方式修改列表	dataq/api/page/getAdvanPaymWayModifyList
病人挂号相关操作	dataq/api/page/getPaitentGHOperList
打印医保卡更换凭证	print/api/query/printDJ_M
补打预交金单	print/api/query/printAdvancePayment
查询数据集	dataset/listDataset
保存数据集	dataset/saveDataset
删除数据集	dataset/removeDataset
更新数据集	dataset/updateDataset
查询数据集类型	dataset/listDatasetType
查询数据集相关系统	dataset/listDatasetSys
查询数据集标准类型	dataset/listDatasetStandard
更正确定前置提示接口	api/costCorrection/beforeBtnOKClick
病人费用更正确定	api/costCorrection/btnOKClick
退费撤销	costCorrection/btnCancelClick
查询收费员结账确认记录	dataq/api/page/qrySettleConfirmedList
查询收费员结账未确认记录	api/page/qrySettleUnconfirmedList
医院结算银行-下拉框	dataq/api/xdict?zdbm=10034
新支付方式	dataq/api/xdict?zdbm=10033
补打取药单	api/compManage/patchPrintTakeMediList
查询结账确认结账发票	dataq/api/page/qryConfirmCheckInvoice
预交金支付方式确认修改	api/compManage/updateMZYWZHCL
查询结账确认结账预交金	dataq/api/page/qryConfirmCheckAdvance
查询结账确认发票明细	dataq/api/page/qryConfirmInvoiceDetails
查询结账确认预交金明细	dataq/api/page/qryConfirmAdvanceDetails
查询结账确认换卡明细	dataq/api/page/qryConfirmChangeCardDetails
查询结账确认退费明细	dataq/api/page/qryConfirmRefundDetails
审核人输入法字典	dataq/api/page/getStaffDictList
病人退号	api/compManage/patientTuiHao
查询门诊汇总清单	api/DailyListQuery/getSummaryList
门诊病人费别信息修改查询	dataq/api/page/getFeeModificationQuery
登录	dist/api/login
查询数据元	dataElement/listElement
保存数据元	dataElement/saveElement
删除数据元	dataElement/removeElement
更新数据元	dataElement/updateElement
账户查询列表	dist/api/accounts
查询数据子集	dataset/listSubDataSet
新增一个产品线	dist/api/pillar
新增产品线/产品图标	dist/api/logo/1
门诊病人信息查询-病人基本信息	dataq/api/page/qryGetBRXX00
门诊病人信息查询-病人账户信息	dataq/api/page/qryGetBRZHXX
门诊病人信息查询-病人交款信息	dataq/api/page/qryGetBRJFXX
门诊病人信息查询-病人费用信息	dataq/api/page/qryGetBRFYXX
门诊病人信息查询-病人费用明细-已或未结算	dataq/api/page/qryGetBRFYMX
门诊病人信息查询-病人未结算费用信息	dataq/api/page/qryGetBRWJSFYXX
门诊病人信息查询-病人已结算费用信息	dataq/api/page/qryGetBRYJSFYXX
获取带产品列表的产品线列表	dist/api/pillars?withProducts
查询产品线列表	dist/api/pillars
查询标准表	tableCollection/listTable
保存标准表	tableCollection/saveTable
删除标准表	tableCollection/removeTable
更新标准表	tableCollection/updateTable
新增一个产品	dist/api/product
新增一个产品版本	dist/api/version
分院名称-下拉框	dataq/api/xdict?zdbm=10026
打印病案首页	print/api/query/printBR_BASY
删除一个产品	dist/api/product/1
查询产品列表	dist/api/products
更新一个产品版本	dist/api/version/11
删除一个产品版本	dist/api/version/11
获取结算项目明细	dataq/api/page/getMZSettlePorjectList
获取病人结算信息列表	api/cancelSettle/getSettleDetailList
查询产品版本列表	dist/api/versions?product=1&withFiles
查询收费员缴款结账列表	dataq/api/page/qrySettleList
导出结账确认发票	dataq/export/qryConfirmCheckInvoice
导出结账确认预交金	dataq/export/qryConfirmCheckAdvance
查询病人列表表头数据	dataq/api/header/queryPatientList
查询病人列表数据	dataq/api/page/queryPatientList
导出确认发票明细	dataq/export/qryConfirmInvoiceDetails
导出确认预交金明细	dataq/export/qryConfirmAdvanceDetails
导出确认换卡明细	dataq/export/qryConfirmChangeCardDetails
导出确认退费明细	dataq/export/qryConfirmRefundDetails
收费员汇总结账单打印	api/settleQuery/printTollTotalSettleBills
全院汇总结账单打印	api/settleQuery/printTotalSettleBills
病人退号回调接口（医保回调、长事务）	api/compManage/callBackPatientTuiHao
查询所有失败记录	errRec/listAllErrRec
根据条件查询失败记录	errRec/listErrRecByParam
删除产品版本介质	dist/api/file/11
根据topic重新消费记录	errRec/reDoErrRecByTopic
根据offset重新消费记录	errRec/reDoErrRecByOffset
门诊病人就诊卡挂失查询	dataq/api/page/qryMedicalCardLose
账户授权查询	dist/api/privilege/account/1
下载记录	dist/api/log
病人费别-下来框	dataq/api/xdict?zdbm=10054
根据费别获取医保中心名称	dataq/api/page/qryMedicalInsuranceName
根据医保中心名称获取病人类别	dataq/api/page/qryPatientsCategory
门诊病人结算查询	dataq/api/page/qrySettlementInquiry
门诊病人结算查询-结算项目明细	dataq/api/page/qryDisplayInvoiceDetails
病人退号前置校验（ODC校验）	api/compManage/patientTuiHaoPreCheck
收费员搜索框	dataq/api/page/getMZTollDictList
门诊病人费用查询-病人挂号信息	dataq/api/page/qryGetMZBRFYCXGHXX
门诊病人费用查询-病人费用信息	dataq/api/page/qryGetMZBRFYCXFYXX
门诊病人费用查询-病人费用明细	dataq/api/page/qryGetMZBRFYCXFYMX
门诊病人费用查询-病人交费信息	dataq/api/page/qryGetMZBRFYCXJFXX
获取页面初始化字典	api/systemParameter/initDict
获取费别下拉列表	dataq/api/xdict?zdbm=10040
门诊病人挂号结果查询	dataq/api/page/getRegistrationResults
门诊挂号结果合计金额查询	api/DailyListQuery/getTotalAmounts
门诊病人取消结算	api/cancelSettle/mzCancelSettle
门诊预交金信息列表	dataq/api/page/getMzOutpAdvanPaymentList
收费员工作量统计	dataq/api/page/queryWorkloadStatistics
新医保接口费用登记冲销获取报文	api/hismzsfyb/getYBFYJSCXReqParam
查询值域	standard/listRange
保存值域	standard/saveRange
更新值域	standard/updateRange
删除值域	standard/removeRange
新医保接口交互后日志写入	api/hismzsfyb/setSendMedicalLog
查询标准值	standard/listValue
保存标准值	standard/saveValue
更新标准值	standard/updateValue
删除标准值	standard/removeValue
查询值域代码分类名称	standard/listRangeName
病人信息修改日志查询	dataq/api/page/quryInformationModificationLog
查询值域标准类型	standard/listRangeType
获取病人字典列表	dataq/api/page/getPatientSelection
分院下拉列表	dataq/api/xdict?zdbm=10026
门诊医保支付情况查询	dataq/api/page/quryMedicalInsurancePayment
通用FR3打印	print/api/query/printFr3
通用FRX打印	print/api/query/printFrx
门诊预交金收退款票据打印	api/bill/printVoucherBillInfo
测试服务器500状态	api/test500
获取票据序号（缴款，退款序号）	api/yjjQuery/getPJXH
补打/重置预交金单	api/yjjQuery/patchPrintYjjBill
获取医保支付方式下拉框	dataq/api/xdict?zdbm=10041
获取医保类别下拉框	dataq/api/xdict?zdbm=10042
门诊医保支付情况查询-医保统筹基金统计	dataq/api/page/getPoolingFundSum
表格列表合并表头数据	dataq/api/header/qrySettleList
表格列表合并表内容数据	dataq/api/page/qrySettleList
医保信息同步	api/DailyListQuery/setYbxxSynchronization
门诊票据使用情况查询	dataq/api/page/queryUsageofBills
获取票据类型下拉框	dataq/api/xdict?zdbm=10029
获取医保需要的Json串	ylz/yb/getInParam
医保返回Json串处理	ylz/yb/setOutParam
获取费别下拉框	dataq/api/xdict?zdbm=10043
根据费别获取医保类别	dataq/api/page/qryMedicalInsuranceCategory
查询医保收费对应目录-药品	dataq/api/page/queryMedicalInsuranceDrugs
查询医保收费对应目录-医疗项目	dataq/api/page/queryMedicalInsuranceProject
门诊现金收入稽核	dataq/api/page/queryRevenueAudit
门诊收费缴款稽核	dataq/api/page/queryPaymentAudit
门诊收费缴款稽核-合计	dataq/api/page/queryPaymentAuditSum
门诊收费缴款稽核-缴款明细	dataq/api/page/queryPaymentDetails
打印缴款单详细信息	print/api/query/printTmzsfptJZD
门诊收费项目稽核-按汇总显示	dataq/api/page/queryPayServiceSummary
门诊收费项目稽核-按明细显示	dataq/api/page/queryPayServiceDetailed
获取科室名称下拉框	dataq/api/xdict?zdbm=10044
获取票据类型下拉框	dataq/api/xdict?zdbm=10021
EMPI注册更新患者信息	api/medicalCard/SendNewPatient
获取分院下拉框	dataq/api/xdict?zdbm=10026
票据使用稽核	dataq/api/page/queryAuditofBillUse
门诊票据使用稽核-判断票据是否作废	dataq/api/page/queryIsTheBillVoid
打印票据使用清单明细	print/api/query/printTMzsfptFPRQD
查询预约病人列表	dataq/api/page/getAppointmentPatients
自动获取预约病人的病历号	api/InformationRegistrations/getMedicalRecordNo
预约病人信息登记	api/InformationRegistrations/setInformationRegistration
获取职退情况下拉框	dataq/api/xdict?zdbm=10022
刷新页面	api/settlePage/refreshPage
获取叫号窗口名称	api/callNumber/getCKMC
住院业务操作排队顺呼叫号	api/callNumber/getOperatePDSFJH
轮询操作返回顺呼和重呼名称	api/callNumber/myOnInnerTimerEvent
重呼	api/callNumber/setOperatePDCFJH
叫号列表查询	dataq/api/page/callNumberList
勾选项目重新计算金额数据	api/settlePage/loadAccountInfo
审批接口	api/medicalCard/approve
交易服务设置成功执行	api/deposit/serviceSetSuccess
统一支付交费执行成功获取单据票据	api/upi/paySuccess
1.结算前验证	api/settleVerify/settlementCheck
2.医保交互前准备	api/settle/doPreparMZSFYBJS
获取特殊病种列表	dataq/api/page/getTSBZBHByList
获取未取化验单	dataq/api/page/getNotTakenReport
getRKDListByYKBMBH	dataq/api/page/getRKDListByYKBMBH
药品字典下拉数据（顶部单个输入框）	dataq/api/page/listYpCkdDict
5.进行费用结算流程	api/settle/execMZSFFYJS
getYPXXListByRKDH	dataq/api/page/getYPXXListByRKDH
odc3 跟医保进行结算	api/settle/execMZSFYBJS
odc4医保费用结算冲销	api/settle/doFYJSYBCX
库存查询-用户登录所属部门性质	dataq/api/page/getNatureOfDepartment
药品树结构-药品搜索	dataq/api/page/getDrugTreeSearch
获取“出库类型”字典（第一个表格中列）	api/yk/drugsOutBaseComp/getYpCkTypeDict
转采购单	api/yk/drugsOutWareInput/transToPurchOrder
药库出库请领单(包括删除、接单、退回请领单)	api/yk/drugsOutWareInput/dealDrugStorApplyMore
保存出库单(请领单)	api/yk/drugsOutWareInput/save
获取药品树列表	api/yk/drugsTree/getDrugsTree
获取药品树列表明细	api/yk/drugsTree/getDrugsTreeMx
getYPGHDWList	dataq/api/page/getYPGHDWList
药品总库存查询	dataq/api/page/getTotalDrugInventory
药品批次库存	dataq/api/page/getBatchInventoryDrugs
药房批次库存	dataq/api/page/getPharmacyBatchInventory
药房库存信息	dataq/api/page/getPharmacyInventory
有效期修改	api/yk/inventoryQuery/updateDate
药品批次库存-使药品是否有效	api/yk/inventoryQuery/updateDrugYX
药房批次库存-使药房是否有效	api/yk/inventoryQuery/updatePharmacyYX
收货方下拉字典（左侧）	dataq/api/page/listSHFDictForYPCKQR
药品总库存-药库零售价独立管理	dataq/api/page/getTotalDrugLSJDLGL
出库记录查询（左侧查询列表）	dataq/api/page/listCKJLForYPCKQR
delGodownEntry	yk/rkdsr/delGodownEntry
获取省市区字典列表	dataq/api/page/getProvCityAreaDictList
获取类别下拉框	dataq/api/xdict?zdbm=10058
过往库存查询	dataq/api/page/getPastInventoryInquiry
药品明细记录（右侧第一个表格）	dataq/api/page/listYpmxJLForYPCKQR
全院药房库存信息（右侧第二个表格）	dataq/api/page/listQyYfKcXxForYPCKQR
获取药品请领明细（第二个表格）	dataq/api/page/listYPMXForYPCKDSR
查询出库单列表（第一个表格）	dataq/api/page/listYPCKDForYPCKDSR
药品历史明细记录(右侧第三个表格)	dataq/api/page/listYpLsMxJLForYPCKQR
病人退费开单--刷新发票信息	api/page/refreshInvoiceInfo
病人退费开单--显示允许申请退费处方	api/page/showCFTFSQ
获取药品名称字典列表	dataq/api/page/getDictionaryDrugNames
输入法获取出入类别字典	dataq/api/page/getAccessCategoryDictionary
退费开单--门诊处方退费确认	dataq/api/page/ShowCFTFQR
退药开单--获取处方明细	dataq/api/page/queryMZCFMX
获取药品树列表	api/yk/drugsTree/getDrugsTree
获取药品树列表明细	api/yk/drugsTree/getDrugsTreeMx
库存查询-用户登录所属部门性质	dataq/api/page/getNatureOfDepartment
表格列表内容数据-懒加载无统计	dataq/api/page/getApproveArrearageListNoCount
药品树结构-药品搜索-表头	dataq/api/header/getDrugTreeSearch
药品树结构-药品搜索	dataq/api/page/getDrugTreeSearch
出入流水账	dataq/api/page/queryInoutJournal
药品账页汇总查询(到药品)	dataq/api/page/queryDrugAccountSummary
会计账页	dataq/api/page/queryAccountingPage
门诊结算--退卡	api/settle/doTK
出库单审核确认	api/yk/drugsOutWareCheck/confirm
出库单确认“确认”/出库单出库“发送”	api/yk/drugsOutWareConfirm/confirm
申领单确认(成功后相关打印)	api/yk/drugsOutWareConfirm/confirmAfter
出库单确认/出库单出库、退回（对应头部“退回”按钮）	api/yk/drugsOutWareConfirm/back
门诊结算发票打印	api/settlePrint/printFPProcZHCL
退药开单--处方退费申请	api/refundBilling/doCFTFSQ_EDIT
退药开单--1.退费确认验证	api/refundBilling/refundConfirmCheck
退药开单--2.处方退费确认	api/refundBilling/doCFTFQR_EDIT
出库单选择、收获方列表发生变化操作	api/yk/drugsOutWareConfirm/dealShfListChanaged
点击新增药品按钮(底部菜单)	api/yk/drugsOutWareInput/addDrugInfo
打印取药单	api/refundBilling/getPrescriptionNum
导出就诊卡信息	api/medicalCard/exportMedicalCardList
打印换卡、补卡凭证	print/api/query/printMZSF_DJ_M
发送入库单号	yk/rkdsr/sendYPRKD
药库入库单（增删改）	yk/rkdsr/saveGodownEntry
到货单列表	dataq/api/page/getDHDList
门诊病人结算查询-结算费用明细	dataq/api/page/qrySettlementOfDetails
到货单对应药品信息列表	dataq/api/page/getDHDYPXXList
打印药库请领单明细_FRX打印(头部第二个打印)	print/api/query/printYcCkQldMx
转入库	yk/rkdsr/changePutInStorage
库单确认列表	dataq/api/page/getRKDQRListByYKBMBH
药库药品出库凭证_FRX打印((头部第三个打印))	print/api/query/printYkYpCkpz
根据身份证计算出 病人的性别、出生日期、出生地	api/medicalCard/getBRXXByBRSFZH
操作员下拉框	dataq/api/xdict?zdbm=10060
获取操作员编号	dataq/api/page/queryDLEmployeeNumber
票据确认	dataq/api/page/queryCZYNoteConfirmation
建档信息	dataq/api/page/queryCZYFilingInformation
卡操作信息	dataq/api/page/queryCZYCardOperationInformation
挂号信息	dataq/api/page/queryCZYRegistrationInformation
预交金信息	dataq/api/page/queryCZYPaymentInformation
发票信息	dataq/api/page/queryCZYInvoiceInformation
结算信息	dataq/api/page/queryCZYSettlementInformation
票据信息	dataq/api/page/queryCZYNoteInformation
缴款信息	dataq/api/page/queryCZYPaymentsInformation
住院登记	dataq/api/page/queryCZYHospitalRegistration
入库确认单对应药品明细列表	dataq/api/page/getRKDQRYPList
打印药库药品备货单(头部第一个打印)	print/api/query/printYkYpBhd
申领单位下拉字典	dataq/api/page/listSLDWDictForYPCKSH
出库管理-出库单审核-出库单记录查询	dataq/api/page/listCkdJlForYPCKSH
出库管理-出库单审核-出库单药品明细	dataq/api/page/listCkdYpMxForYPCKSH
获取物资属性字典	dataq/api/xdict
出库单审核打印_药库出库单凭证	print/api/query/printYpCkdPz
打印成功后更新打印次数	api/yk/drugsOutBaseComp/updatePrintNum
库存量限额查询	dataq/api/page/queryDrugInventoryLimit
药品信息修改	api/yk/inventoryLimit/updateDrugXinXi
输入法定位药品字典	dataq/api/page/getPositioningDrugs
有效期管理查询	dataq/api/page/queryValidityManagement
滞销药品管理	dataq/api/page/queryUnsalableDrugs
处方排号	api/settlePrint/printPrescriptionList
打印未取号提示信息	api/settlePrint/printWQHTSXX
药品有效期管理打印	print/api/query/printYpYxqGlb
滞销药品管理打印	print/api/query/printZxYpGlb
出库单位下拉框	dataq/api/page/listCkDWDictForYPCKCWGZ
出库单查询	dataq/api/page/listCkdForYPCKCWGZ
转入库	yk/rkdqr/tBtnConfirmClick
出库单对应药品信息列表查询	dataq/api/page/listYpxxForYPCKCWGZ
审核后的打印	yk/rkddy/afterRKDQRSHPrint
增加打印次数	yk/rkddy/upYPRKDCS
入库单退回	yk/rkdqr/godownEntryBack
入库单确认后，是否入库审核	yk/rkdqr/isCheckRK
药库药品分类类别-根据部门编号获取	dataq/api/page/getClassificationOfDrugs
药品库存预警-全院库存	dataq/api/page/queryHospitalInventory
药品库存预警-不统计药房耗量	dataq/api/page/queryInventoryWarning
药品库存预警-统计药房耗量	dataq/api/page/queryInventoryWarningss
冲销	api/yk/drugsOutErrorCorre/writeOff
冲销成功后的打印	api/yk/drugsOutErrorCorre/writeOffAfterPrint
整单取回	api/yk/drugsOutErrorCorre/backWriteOff
查询病人信息-新	api/medicalCard/qryPatientList
入库单审核供货商下拉	dataq/api/page/getRKSHGHDWList
查询入库单审核列表	dataq/api/page/getRKDSHList
门诊结算测试数据	api/settlePage/qrySettle
入库单审核单对应药品列表	dataq/api/page/getRKDSHYPList
退库单输入-退库单列表	dataq/api/page/getTKDSRList
退库单输入-退库单对应药品列表	dataq/api/page/getTKDSRYPList
退库单输入-退库部门列表	dataq/api/page/getTKBMList
药品已审核的入库记录	dataq/api/page/listYpYshRkJlForRKDCK
已出库记录	dataq/api/page/listYpYckJlForRKDCK
打印变更单-FRX	print/api/query/printMZSF_BGDFRX
药品明细列表	dataq/api/page/listYpmxLbForRKDCK
退库单输入-发送退库单号	yk/tkdsr/sendTKDH
领用部门字典	dataq/api/page/listLybmDictForRKDCK
经领人下拉框字典	dataq/api/page/listJLRDictForRKDCK
出库类型	dataq/api/xdict
增加	api/yk/drugsOutForInStorBill/add
收货方下拉框字典	dataq/api/page/listYkYfSHFDict
删除	api/yk/drugsOutForInStorBill/del
修改	api/yk/drugsOutForInStorBill/update
出库单列表（第一个表格）	dataq/api/page/listCkdlbForCKDCX
药品名称下拉字典（底部）	dataq/api/page/listYPMCDictForYPCKDSR
生产厂家列表	dataq/api/page/getRKSCSJList
货柜号列表	dataq/api/page/getRKHGHList
获取药品明细信息(底部药品名称字典退出时)	api/yk/drugsOutWareInput/getYpxxYpmcDictExit
入库类型列表	dataq/api/page/getRKLXList
药品搜索列表	dataq/api/page/getRKYPList
药品库存预警-生成采购单	api/yk/inventoryWarning/generatePurchaseOrder
查询时间段内调价单树	api/yk/kjsh/getDadjapTree
调价管理性质字典	dataq/api/xdict?zdbm=10063
药库部门字典	dataq/api/xdict?zdbm=10064
查询调价单主数据	api/yk/kjsh/getDadjapMain
药品调价明细	dataq/api/page/getDrugPriceAdjustmentList
待审核药品调价单库存明细	dataq/api/page/auditingDrugPriceAdjustmentInventoryList
调价单审批文件号输入法字典	dataq/api/page/approvalDocumentNoListDict
已执行药品调价单库存明细	dataq/api/page/executedDrugPriceAdjustmentInventoryList
调价单药品查找输入法字典	dadjapDrugListDict
药品明细列表	dataq/api/page/listYpmxlbForCKDCX
取消审核	api/yk/drugsOutBillQuery/cancelCheck
退库单输入-批号列表按请领单	dataq/api/page/getTKDSRPHList
退库单确认-退库单确认列表	dataq/api/page/getTKDQRList
退库单确认-退库单确认对应药品列表	dataq/api/page/getTKDQRYPList
查询时间段内不同状态下盘点单树	api/yk/totalDrugInventoryService/getPddState
调价单保存	api/yk/kjsh/saveDadjap
非编辑状态下删除	api/yk/kjsh/deleteDadjapDetail
调价单审核	api/yk/kjsh/updateDadjapAudit
退库单确认-退库单退回	yk/tkdqr/cancelStocksBack
退库单审核列表	dataq/api/page/getTKDSHList
退库单审核对应药品列表	dataq/api/page/getTKDSHYPList
调价单确认	api/yk/kjsh/confirmDadjapAudit
退库单确认	yk/tkdqr/tkdConfirm
退库单审核	yk/tkdqr/tkdConClick
错误更正列表	dataq/api/page/getRKCWGZList
错误更正药品列表	dataq/api/page/getRKCWGZYPList
查询时间段内不同状态下盘点单详细信息	dataq/api/page/getInventoryNumberInformation
收货方（供应商）下拉字典	dataq/api/page/listTHCKSHFDictForYPCKSR
查询时间段内不同状态下盘点单树	api/yk/totalDrugInventoryService/getPddState
获取其他调价涉及到的药品部门(打印其他库房调价单)	api/yk/kjsh/getOtherTJYK
调价单打印	print/api/query/drugPriceAdjustmentList
错误更正冲销	yk/rkdcwgz/rkdCounteract
查询时间段内药品进、出、存月报表树	api/yk/kjsh/getDrugDeliveryAndStorageTree
药品进、出、存月报表	dataq/api/page/drugDeliveryAndStorageList
结存尾差明细--购进金额尾差	dataq/api/page/JCWCMX_GJJEWC
结存尾差明细--零售金额尾差	dataq/api/page/JCWCMX_LSJEWC
出库单查询-打印（导出成Excel表格）	api/yk/drugOut/queryCkdExport
重新打印(调用完，调用更新打印次数接口)	api/yk/drugsOutBillQuery/reprint
药品进出存月报表结转取消	api/yk/kjsh/drugDeliveryAndStorageCancel
获取新建结转默认时间	api/yk/kjsh/getNewCarriedForwardTime
药品进出存月报表新建结存	api/yk/kjsh/drugDeliveryAndStorageAdd
药品进出存月报表结转审核	api/yk/kjsh/drugDeliveryAndStorageAudit
修改供货单位	yk/rkdcwgz/updRecipients
药品进、出、存月报表打印	print/api/query/drugDeliveryAndStorage
打印	print/api/query/printYyYkYpSld
采购部门下拉字典	dataq/api/page/listPurchDeptDictForCGGL
药库-库存管理-药品总量盘点-新开单和已作废以及待录入	dataq/api/page/queryYKypzlpdXKhZFhRL
药库-库存管理-药品总量盘点-待录入汇总	dataq/api/page/queryYKypzlpdDRLHZ
药库-库存管理-药品总量盘点-已确认	dataq/api/page/queryYKypzlpdYQR
药库-库存管理-药品总量盘点-待确认和已确认下的盘点子单	dataq/api/page/queryYKypzlpdDHYPDZD
getCXTJRKDList	dataq/api/page/getCXTJRKDList
getCXTJRKDYPList	dataq/api/page/getCXTJRKDYPList
退库单输入-批号列表不按请领单	dataq/api/page/getTKDSRPHNOTQLDList
获取采购单记录树	api/yk/drugsProcuBase/listCGDTree
采购主单信息数据	dataq/api/page/listCgZdxxForCGJHZD
入库单合并打印_入库单	dataq/api/page/getRKDHBDY_RKD
入库单合并打印_退货单	dataq/api/page/getRKDHBDY_THD
入库单合并打印_入库单_明细	dataq/api/page/getRKDHBDY_RKD_MX
入库单合并打印_退货单_明细	dataq/api/page/getRKDHBDY_THD_MX
cancelCheckRKD	yk/rkdcx/cancelCheckRKD
入库单合并打印_退货单_明细	dataq/api/page/getRKDHBDY_THD_MX
入库单药品列表	dataq/api/page/getBRFPYPList
入库单列表	dataq/api/page/getBRFPRKDList
底部+列选择变更“计价数量”发生变化后触发	api/yk/drugsOutWareInput/dealQLSLTxtChgAfter
供应商下拉列表	dataq/api/page/getRKQRGHDWList
底部+列选择变更，计量请领数量(余数)发生变化后触发	api/yk/drugsOutWareInput/dealJLQLSLTxtChgAfter
更新单盘点单号(删除、作废、退回、恢复)	api/yk/totalDrugInventoryService/updateInventoryNo
删除盘点单号下的药品详细内容	api/yk/totalDrugInventoryService/deletePddDrugsXX
确认单盘点单号(发送、请求确认、确认)	api/yk/totalDrugInventoryService/confirmInventoryNo
采购明细信息列表(第二个表格)	dataq/api/page/listCgMxxxForCGGL
药品全院各药房库存情况(第三个表格)	dataq/api/page/listYpqyGyfKcqkForCGGL
新增主单	api/yk/makePurchasPlan/addMainBill
删除主单	api/yk/makePurchasPlan/delMainBill
退库单确认供货商下拉	dataq/api/page/getTKQRGHDWList
退库单审核供货商下拉	dataq/api/page/getTKSHGHDWList
入库单更正供应商下拉	dataq/api/page/getRKGZGHDWList
出库单药品列表（勾选出库）	dataq/api/page/getBRFPCKYPList
补录发票保存	yk/blfp/saveInvoice
费用清单信息表头测试数据	dataq/api/header/ComprehensiveExpenseDetails
费用清单信息表内容测试数据	dataq/api/page/ComprehensiveExpenseDetails
供应商下拉	dataq/api/page/getFKTZDGHDWList
汇款单记录	dataq/api/page/getFKTZDHKDList
汇款状态树供货商列表	dataq/api/page/getFKTZDGHDWBYHKDZTList
汇款单信息列表	dataq/api/page/getFKTZDHKDXXList
打印医保卡保管单	print/api/query/printZYSF_YBKBGD
药品字典下拉框	dataq/api/page/listYpDictForCGGL
生产厂家字典下拉框	dataq/api/page/listSccjDictForCGGL
保存盘点单号下的药品详细内容	api/yk/totalDrugInventoryService/preservationPddDrugsXX
汇款生成单列表	dataq/api/page/getFKTZDHKDSCDList
汇款生成单药品列表	dataq/api/page/getFKTZDHKDSCDYPList
盘点单生成-按品种盘点	dataq/api/page/queryYKpddscAPZPD
盘点单生成-按批次盘点	dataq/api/page/queryYKpddscAPCPD
盘点单生成-按价格盘点	dataq/api/page/queryYKpddscAJGPD
采购明细“保存”按钮	api/yk/makePurchasPlan/save
获取采购明细（返回采购数量不为0的结果）	api/yk/makePurchasPlan/listCGMXForCGSLNotZero
采购明细信息“导出”	api/yk/makePurcPlan/exportCgmxToExcel
药品字典（采购计划明细_添加按钮_弹出字典）	dataq/api/page/listYpcgDictForCGGL
药品采购字典点击“确认”触发事件	api/yk/makePurchasPlan/cxBtQDClick
取上月的量	api/yk/makePurchasPlan/getLastMonthAmount
抽样盘点-按品种盘点	dataq/api/page/queryYKcypdAPZPD
抽样盘点-按批次盘点	dataq/api/page/queryYKcypdAPCPD
抽样盘点-按价格盘点	dataq/api/page/queryYKcypdAJGPD
查询采购单列表（第一个表格）	dataq/api/page/listCgdForCGJHDCX
出库单列表	dataq/api/page/getBRFPCKDList
新生成汇款单	yk/fktzsdy/newCreateHKD
查询药品明细信息列表（第二个表格）	dataq/api/page/listYpMxxxForCGJHDCX
审核	yk/fktzsdy/approve
取消核准	yk/fktzsdy/cancelApprove
作废	yk/fktzsdy/cancellation
采购计划单 打印	print/api/query/printYpCgjhd
期初入库	api/yk/totalDrugInventoryService/whetherQCRuKu
生成盘点单	api/yk/totalDrugInventoryService/generatePdd
判断原单添加新药品盘点是否重复	api/yk/totalDrugInventoryService/judgeDrugXXRepeat
合并打印	api/yk/queryPurchasPlan/mergePrint
更新打印次数	api/yk/queryPurchasPlan/modifyPrintNum
导出	api/yk/makePurcPlan/exportCgjhToExcel
取消盘点状态	api/yk/cancelCountingStatusService/ancelPddStatus
接口导出	api/yk/makePurcPlan/exportCgjhApiToExcel
获取采购单记录树	api/yk/drugsProcuBase/listCGDTreeForCGGYSDJ
采购主单信息数据列表	dataq/api/page/listCgzdForCGGYSDJ
查询采购明细信息列表	dataq/api/page/listCgMxxxForCGGYSDJ
统一供应商	api/yk/procSuppReg/unifiedSupplier
保存	api/yk/procSuppReg/save
发送	api/yk/procSuppReg/send
药库会计过账-调拨单	dataq/api/page/listAccountingPosting
药库会计过账-调拨单明细	dataq/api/page/listAccountingPostingMX
会计过账确认	api/accountingPosting/confirm
药品信息查询	dataq/api/page/queryQtsxwhYpxxcx
输入法拆分信息字典	dataq/api/page/getSRFcfxxZD
输入法门诊开方单位字典	dataq/api/page/getSRFmzkfZD
输入法用法字典	dataq/api/page/getSRFyfZD
输入法频次字典	dataq/api/page/getSRFpcZD
查询采购主单列表	dataq/api/page/listCgzdForCGJHSH
输入法中标期字典	dataq/api/page/getSRFzbqZD
输入法生产厂家字典	dataq/api/page/getSRFsccjZD
输入法供货单位字典	dataq/api/page/getSRFghdwZD
输入法产地名称字典	dataq/api/page/getSRFcdmcZD
输入法贮藏方法字典	dataq/api/page/getSRFzcffZD
输入法配制台字典	dataq/api/page/getSRFpztZD
输入法发药属性字典	dataq/api/page/getSRFfysxZD
采购明细信息列表	dataq/api/page/listCgMxxxForCGJHSH
保存	api/yk/purcPlanAudit/save
审核/退回单据	api/yk/purcPlanAudit/audit
申领单消息列表	dataq/api/page/getYFRKSLDXXList
分页测试数据	dataq/api/page/pageDatas
药库入库单合并打印_入库单合并打印	print/api/query/printYKRKHBDY_RKD
药库入库单合并打印_入库单打印	print/api/query/printYKRKHBDY_RK
药库入库单合并打印_退货单打印	print/api/query/printYKRKHBDY_THD
保存修改药品后的信息	api/yk/OtherAttributeService/updateDrugsAttribute
查询采购主单列表	dataq/api/page/listCgzdForCGWH
查询采购明细信息列表	dataq/api/page/listCgMxxxForCGWH
采购单树	api/yk/drugsProcuBase/listCGDTreeForCGWH
发送	api/yk/purchasMaint/send
修改（修改保存前的验证）	api/yk/purchasMaint/editCheck
作废	api/yk/purchasMaint/notNeed
保存	api/yk/purchasMaint/save
获取可编辑的结果列（采购明细列表）	api/yk/purchasMaint/getEditColsList
药品字典选择后，获取采购明细信息	api/yk/purchasMaint/getCgxxYpmcDictExit
类别	dataq/api/page/queryTSSXWHlb
根据类别编号获取药理	dataq/api/page/getGJLBBHhqYL
根据类别编号获取剂型	dataq/api/page/getGJLBBHhqJX
查询最高定价维护	dataq/api/page/queryZGDJWH
保存修改药品定价后的信息	api/yk/MaximumPricingService/updateDrugszgPricing
打印住院收费_预交金退款汇总单	print/api/query/printZYSF_YJJTKHZD
查询特殊药品维护	dataq/api/page/queryTSYPWH
保存修改药品后的信息	api/yk/SpecialDrugsService/updateSpecialDrugs
打印	print/api/query/printYpYgCgd
药品名称下拉框字典	dataq/api/page/listYpcgDictForCGWH
查询药品存放位置	dataq/api/page/queryDrugStorageLocation
删除药品存放的信息	api/yk/DrugStorageLocationService/deleteDrugStorageLocation
保存增加和修改药品存放的信息	api/yk/DrugStorageLocationService/updateDrugStorageLocation
获取采购单记录树	api/yk/drugsProcuBase/listCGDTreeForCGJHSH
查询药品类别维护	dataq/api/page/queryDrugCategoryMaintenance
保存修改药品默认加成率	api/yk/DrugCategoryMaintainService/updateDrugMRJCL
采购单树	api/yk/drugsProcuBase/listCGDTreeForCGDJ
展开行测试数据	dataq/api/page/expandDatas
行分组测试数据	dataq/api/page/groupByDatas
获取借药单主数据	api/yf/ckksjy/getBorrowMedicineMain
获取药房借药单明细	dataq/api/page/getBorrowMedicineList
采购主单信息查询	dataq/api/page/listCgzdForCGDJ
采购明细	dataq/api/page/listCgMxxxForCGDJ
借药部门输入法字典	dataq/api/page/JYBMListDict
科室借药_借药人输入法字典	dataq/api/page/KSJYJYRListDict
弹框编辑测试数据	dataq/api/page/popupFormDatas
申领单消息明细列表	dataq/api/page/getYFRKSLDXXMXList
申领单模板搜索/模板维护-模板搜索	dataq/api/page/getYFSLDMBList
模板维护-申领单药品明细列表	dataq/api/page/getYFMBWHMBMX
拼音五笔根据中文判断	dataq/api/page/getPYWBGJZWPD
科室借药_药品输入法字典	dataq/api/page/KSJYYPListDict
查询药品剂型维护的信息	dataq/api/page/queryYPJXWHDXX
采购确认	api/yk/purchRegis/confirm
删除药品剂型维护的信息	api/yk/DrugDosageFormService/deleteDrugDosageForm
保存增加和修改药品剂型维护的信息	api/yk/DrugDosageFormService/updateDrugDosageForm
科室借药登记明细切换单位	api/yf/ckksjy/switchingUnit
模板引用-明细列表	dataq/api/page/getYFSLDMBYYMXList
保存	api/yk/purchRegis/save
“回退”或“作废”或“作废恢复”操作	api/yk/purchRegis/dealByType
明细删除	api/yk/purchRegis/delYkDhdMx
模板维护-新增-搜索药品	dataq/api/page/getYFSLDMBXZYPList
组套名称字典下拉框	dataq/api/page/listZtmcDictForCGDJ
获取模板类别编号	api/yf/rksldsr/getMBLBBH
科室借药登记保存	api/yf/ckksjy/registerSave
科室借药登记删除	api/yf/ckksjy/registerDelete
新增模板	api/yf/rksldsr/addApplyTemplate
修改模板明细	api/yf/rksldsr/updApplyTemplate
删除模板明细	api/yf/rksldsr/delApplyTemplate
获取供货单位维护下一个编号	dataq/api/page/getGHDWXYGBH
查询供货单位维护的信息	dataq/api/page/queryGHDWWHDXX
保存增加和修改供货单位的信息	api/yk/SupplyCompanyService/updateSupplyCompany
发药方列表	dataq/api/page/getYFFYFList
借药单审核	api/yf/ckksjy/borrowMedicineCheck
药房-出库-科室借药审核主数据	dataq/api/page/getBorrowMedicineCheckList
药房-出库-科室借药审核,确认明细	dataq/api/page/getBorrowMedicineCheckMXList
虚拟滚动测试数据	dataq/api/page/scrollDatas
查询未审核的出库单记录(第一个表格)	dataq/api/page/listYfWshCkdForCKDSR
查询出库单药品明细	dataq/api/page/listYfCkypmxForCKDSR
出库类型字典	dataq/api/xdict
收货方下拉框字典	dataq/api/page/listYkYfSHFDict
收货方下拉框字典	dataq/api/page/listYkYfSHFDict
获取生产厂家维护下一个编号	dataq/api/page/getSCCJXYGBH
经领人下拉字典	dataq/api/page/listYfJLRDict
查询生产厂家维护的信息	dataq/api/page/querySCCJWHDXX
保存增加和修改生产厂家的信息	api/yk/ProductionManufactorService/updateProductionManufactor
 新增申领单	api/yf/rksldsr/addApply
 删除申领单	api/yf/rksldsr/delApply
 发送申领单	api/yf/rksldsr/sedApply
 读取耗量	api/yf/rksldsr/getWastageCount
药品名称字典	dataq/api/page/listYfYpmcDict
大数据表格测试-表头	dataq/api/bigDataHeader
大数据表格测试-列表数据	dataq/api/bigDataPage
查询隶属药品维护-需要添加(上面表格)	dataq/api/page/queryLSYPWHXYTJ
查询隶属药品维护-需要除去(下面表格)	dataq/api/page/queryLSYPWHXYCQ
添加药品的信息	api/yk/SubordinateDrugsService/insertSubordinateDrugs
移去药品的信息	api/yk/SubordinateDrugsService/deleteSubordinateDrugs
查询协定处方对照维护的药品信息	dataq/api/page/queryXDCFDZwhdYPXX
查询协定处方对照维护的对应药品信息	dataq/api/page/queryXDCFDZwhddyYPXX
输入法协定处方对照维护的药品名称字典	dataq/api/page/getXDCFDZwhdYPMC
 取回	api/yf/rksldsr/recaption
查询协定处方对照维护的药品名称字典详细信息	dataq/api/page/queryXDCFDZwhdYPMCXX
 作废	api/yf/rksldsr/cancelled
 申领单确认列表	dataq/api/page/getYFRKSLDQRList
 申领单确认明细列表	dataq/api/page/getYFRKSLDQRMXList
药房出库科室借药单打印	print/api/query/printYFCKKSJYD
药房-出库-科室借药确认主数据	dataq/api/page/getBorrowMedicineNotarizeList
申领单输入新增搜索药品	dataq/api/page/getYFSLDXZYPList
 确认	yf/rksldqr/affirm
增加或者修改对照处方的信息	api/yk/PrescriptionControlService/updateControlPrescription
与药典对比是否一致	api/yk/PrescriptionControlService/queryYYDDBSFYZ
删除对照处方的信息	api/yk/PrescriptionControlService/deleteControlPrescription
 供货部门列表	dataq/api/page/getYFGHBMList
 入库类型列表	dataq/api/page/getRKLXList
 药品列表	dataq/api/page/getYFRKSRYPList
保存	api/yf/wareInput/save
删除	api/yf/wareInput/delYpCkd
获取药品明细信息(在药品名称字典退出时候)	api/yf/wareInput/getCkmxxxByYpmczdExit
借药单确认	api/yf/ckksjy/borrowMedicineNotarize
“备注”按回车键触发（底部备注文本框）	api/yf/wareInput/enterBzNext
“计价数量”（底部）发生变化触发	api/yf/wareInput/dealJJCKSLTxtChgAfter
“余数”（底部）发生变化触发	api/yf/wareInput/dealJLCKSLTxtChgAfter
 入库单增/删/改	api/yf/rkdsr/save
确认列表	dataq/api/page/getYFRKQRList
确认药品列表	dataq/api/page/getYFRKQRYPList
查询特殊属性的药品信息（左边药品）	dataq/api/page/queryTSSXDYPXX
查询特殊属性维护信息（上面表格）	dataq/api/page/queryTSSXWHXX
查询特殊属性所需要维护信息（下面表格）	dataq/api/page/queryTSSXSXYWHXX
选择和移去属性信息保存	api/yk/SpecialPropertiesService/updateSpecialProperties
药房-出库-科室借药查询主数据	dataq/api/page/getBorrowMedicineSelectList
药房-出库-科室借药查询明细	dataq/api/page/getBorrowMedicineSelectMXList
科室借药单转出库单	api/yf/ckksjy/turnOutboundOrder
出库单列表	dataq/api/page/listYfCkdForYFCKDSH
 入库单确认	api/yf/rkdsr/godownAffirm
出库单明细	dataq/api/page/listCkdMxForYFCKDSH
获取报损出库的审核权限	api/yf/wareCheck/getBSCKLXInfo
查询药品别名维护药品信息(上表格)	dataq/api/page/queryYPBMWHDrugsXX
查询药品别名维护别名信息(下表格)	dataq/api/page/queryYPBMWHBmXX
删除药品别名	api/yk/drugAlias/deleteDrugAlias
保存增加或者修改药品别名	api/yk/drugAlias/updateDrugAlias
根据年龄计算出生日期	api/medicalCard/getAgeToBirth
查询药品药理维护-药理信息(包括搜索)	dataq/api/page/queryYPYLWHylXX
查询药品药理维护-通用名信息(包括搜索)	dataq/api/page/queryYPYLWHtymXX
药品通用名维护信息保存	api/yk/DrugsPharmacologyService/updateYpYlWhTYM
药品药理维护信息保存	api/yk/DrugsPharmacologyService/updateYpYlWhYL
自动分组表头测试数据-表头	dataq/api/header/headerGroups
自动分组表头测试数据-表内容	dataq/api/page/headerGroups
药房药品借药申请单	dataq/api/page/listYFYPJYSQD
药房药品借药申请单明细	dataq/api/page/listYFYPJYSQDMX
获取借药单号	api/yf/drugApplication/getJYDH00
药房药品借药药房	dataq/api/xdict
药房药品借药申请_药品输入法字典	dataq/api/page/YFYPJYSQYPListDict
借药申请保存	api/yf/drugApplication/borrowDrugSave
确认	api/yf/wareCheck/confirm
“确认”操作成功后续打印/提示框	api/yf/wareCheck/confirmAfter
退库单明细	dataq/api/page/listTkdmxForTKDSR
药库-下拉框字典	dataq/api/xdict
查询之前校验数据	api/yf/retStockInput/checkBeforeCkdQuery
药品目录维护-材质分类	dataq/api/xdict?zdbm=10069
药品目录维护-单位	dataq/api/xdict?zdbm=10070
药品目录维护-会计	dataq/api/xdict?zdbm=10072
药品目录维护-门诊发票	dataq/api/xdict?zdbm=10073
药品目录维护-住院发票	dataq/api/xdict?zdbm=10074
药品目录维护-核算项目	dataq/api/xdict?zdbm=10075
分组表头测试数据1	dataq/api/header/headerGroups1
药品目录维护-病案	dataq/api/xdict?zdbm=10077
药品目录维护-医嘱属性	dataq/api/xdict?zdbm=10078
药品目录维护-药品科目	dataq/api/xdict?zdbm=10079
药品目录维护-门诊、住院取整	dataq/api/xdict?zdbm=10080
药品目录维护-药品性质	dataq/api/xdict?zdbm=10083
药品目录维护-金额性质	dataq/api/xdict?zdbm=10084
药品目录维护-打印剂型	dataq/api/xdict?zdbm=10086
药品目录维护-注射剂打印类别	dataq/api/xdict?zdbm=10087
分组表头表内容测试数据1	dataq/api/page/headerGroups1
药品目录维护-皮试类型	dataq/api/xdict?zdbm=10088
药品目录维护-抗生素	dataq/api/xdict?zdbm=10089
药品目录维护-中标期	dataq/api/xdict?zdbm=10090
药品目录维护-用药医保类别	dataq/api/xdict?zdbm=10091
药品目录维护-特定用药	dataq/api/xdict?zdbm=10092
药品目录维护-高危等级	dataq/api/xdict?zdbm=10093
药品目录维护-医保单位	dataq/api/xdict?zdbm=10094
药品目录维护-门诊开发单位	dataq/api/xdict?zdbm=10095
药品目录维护-医保比例医保类别	dataq/api/xdict?zdbm=10096
药品目录维护-贮藏方法	dataq/api/xdict?zdbm=10097
药品目录维护-摆药类型	dataq/api/xdict?zdbm=10098
药库-药品目录维护-药品信息	dataq/api/page/queryYPMLWHDrugsXX
分组表头+筛选功能测试数据	dataq/api/header/headerGroupsFilters
分组表头+筛选功能表内容测试数据	dataq/api/page/headerGroupsFilters
药库-药品目录维护-药品核对	dataq/api/page/queryYPMLWHDrugsHD
排序功能表头测试数据	dataq/api/header/sorts
排序功能表内容测试数据	dataq/api/page/sorts
药库-药品目录维护-药品分发-不拥有该药	dataq/api/page/queryYPMLWHDrugsFAbyygy
药库-药品目录维护-药品分发-拥有该药	dataq/api/page/queryYPMLWHDrugsFAyygy
药库-药品目录维护-医保对应	dataq/api/page/queryYPMLWHYBDY
药库-药品目录维护-科室专用-临床科室	dataq/api/page/queryYPMLWHKSZYLCKS
药库-药品目录维护-科室专用-专用科室	dataq/api/page/queryYPMLWHKSZYZYKS
打印变更单-改造	api/medicalCard/printMZSF_BGD
药品目录维护-剂型	dataq/api/page/getYPMLWHJX
获取门诊收费结账表票据序号	dataq/api/page/listSFJzbPJXH
发票清单打印-标准格式	print/api/query/printTmzsfptFPRQD4FRX
发票清单打印-汇总单行	print/api/query/printTmzsfptRQDHZ4FRX
点击“修改”按钮	api/yf/retStockInput/modify
点击删除按钮	api/yf/retStockInput/del
保存	api/yf/retStockInput/save
保存后续操作（包括打印）	api/yf/retStockInput/saveAfter
药品名称字典	dataq/api/page/listYpmcDictForTKDSR
生产批次字典	api/yf/retStockInput/listScpcDict
获取药品明细信息-单条(在鼠标离开“药品名称”字典时候)	api/yf/retStockInput/getYprkmxByYpmczdExit
获取药品明细信息-单条(在鼠标离开“生产批次”字典时候)	api/yf/retStockInput/getYprkmxByScpczdExit
获取厂家字典	dataq/api/page/listCjDictForTKDSR
获取存放位置字典	dataq/api/page/listCfwzDictForCKDSR
滚动功能表内容测试数据	dataq/api/page/rolling
滚动功能表头测试数据	dataq/api/header/rolling
退库单记录查询	dataq/api/page/listTkdjlForTKDXG
入库明细列表“数量”发生变化触发	api/yf/retStockInput/queryYprkmxAmountSetText
退库单明细	dataq/api/page/listTkdmxForTKDXG
打印	api/yf/retStockInput/getPrintTKD
退库单记录查询	dataq/api/page/listTkdjlForTKDSH
退库单明细查询	dataq/api/page/listTkdmxForTKDSH
药品核对计算领药量费用	api/yk/CatalogMaintenanceService/calculationYPHDLYL
药品核对计算领药量	api/yk/CatalogMaintenanceService/updateLYLAccurate
确认	api/yf/retStockCheck/confirm
查询出库单	dataq/api/page/listCkdForYFCKCX
借药单明细查询	dataq/api/page/listCkdmxForYFCKCX
打印	api/yf/wareQuery/print
获取隶属药品信息	dataq/api/page/queryMedicInfo
新增隶属药品信息	api/yf/lsypwh/addLsyp
修改隶属药品信息	api/yf/lsypwh/editLsyp
删除隶属药品信息	api/yf/lsypwh/delLsyp
全暂停隶属药品信息	api/yf/lsypwh/changeAllYPState
导出隶属药品信息	api/yf/system/exportSubsidiaryDrugInformation
获取药品信息	dataq/api/page/queryYPBMWHYPXX
获取别名信息	dataq/api/page/queryYPBMWHBMXX
新增别和修改名信息	api/yf/drugAlias/updateDrugAlias
出库单明细输出（导出）	api/yf/wareQuery/exportCkdmxToExcel
删除别名信息	api/yf/drugAlias/deleteDrugAlias
获取打印机设置信息	api/yf/system/getPrinterConfigurationInformation
打印机配置修改	api/yf/system/updatePrinterConfigurationInformation
获取药品信息	dataq/api/page/getDrugInformation
获取已分发科室信息	dataq/api/page/getDepartmentInformationDistributed
获取未分发科室信息	dataq/api/page/getDepartmentInformationUnDistributed
获取已分发药品信息	dataq/api/page/getDistributedDrugInformation
新增药品分发	api/yf/medicineDistribution/addMedicineDistribution
新增所有药品分发	api/yf/medicineDistribution/addAllMedicineDistribution
删除药品分发	api/yf/medicineDistribution/deleteMedicineDistribution
删除所有药品分发	api/yf/medicineDistribution/deleteAllMedicineDistribution
登录组件	login
受理接口	api/work/accept
出库单（主单）查询之前校验、检查	api/yf/outErrCorrect/checkBeforeCkdQuery
出库单明细	dataq/api/page/listCkdmxForCKCWGZ
转发操作	api/work/forward
完成操作	api/work/solve
关闭	api/work/close
附件上传	work/file/upload
查看附件	work/file/check
获取药品信息	api/yf/preparationTableDistribution/getDrugInformation
取消操作	api/work/cancel
获取已分发药品信息	dataq/api/page/getMixDistributedDrugInformation
进度条	api/work/schedule
查看详情	api/work/info
获取配制台信息	dataq/api/page/getMixingTableInformation
删除接口	api/work/del
冲销	api/yf/outErrCorrect/writeOff
打印	print/api/query/printYpCkdForCKCWGZ
新增配制台分发记录	api/yf/preparationTableDistribution/addMixingTableInformation
删除配制台分发记录	api/yf/preparationTableDistribution/deleteMixingTableInformation
入库单查询	dataq/api/page/listRkdForRKCX
入库单明细查询	dataq/api/page/listRkdmxForRKCX
转出库单	api/yf/enterWareQuery/transOutWareOrder
打印	api/yf/enterWareQuery/print
合并打印	api/yf/enterWareQuery/mergePrint
查询出库单明细	dataq/api/page/listJcdmxForKSJYSR
查询寄存单明细之前校验、检查	api/yf/deptDeposMedi/checkBeforeJcdmxQuery
删除	api/yf/deptDeposMedi/del
获取寄存明细信息(在药品名称字典退出时候)	api/yf/deptDeposMedi/getJcdmxByYpmczdExit
保存	api/yf/deptDeposMedi/save
寄存部门字典列表	dataq/api/page/listYFGHBMDict
寄存人员字典列表	dataq/api/page/listYFJcryDict
寄存单“数量”发生变化，获取相关金额信息	api/yf/deptDeposMedi/getJcdmxByJCSL00Chg
打印换卡、补卡凭证-改造	api/medicalCard/printMZSF_DJ_M
寄存单查询	dataq/api/page/listJcdForKSJY
寄存单明细查询	dataq/api/page/listJcdmxForKSJYQR
确认	api/yf/deptDeposMediCfm/confirm
打印寄药单	print/api/query/printKSJYD
代煎操作—查询代煎记录（左上表格）	dataq/api/page/listYfDJJLForZYDJDJ
获取操作类型（在查询表格数据之前）	api/yf/regMedicDecoct/getCZLX
代煎操作—查询代煎信息记录（右侧上方表格）	dataq/api/page/listYfDJJLMXForZYDJDJ
查询代煎处方明细记录（代煎操作左下、右下，代煎单查询-“显示处方”	dataq/api/page/listYfDJCFMXForZYDJDJ
代煎单查询—查询代煎单	dataq/api/page/listYfDJDForZYDJDJCX
代煎单查询—病区字典	dataq/api/page/listBqzdForZYDJDJCX
药品分发的科室添加及删除	api/yk/CatalogMaintenanceService/updateDrugDistribution
科室专用的拥有该药的科室添加及删除	api/yk/CatalogMaintenanceService/updateDepartmentSpecific
代煎操作—“条码”回车事件	api/yf/regMedicDecoct/edtLocTXMKeyPress
代煎操作-员工字典	dataq/api/page/listYGZDForZYDJDJCZ
代煎单查询-“条码”回车事件	api/yf/regMedicDecoct/edtLocTXMCXKeyPress
代煎操作	api/yf/regMedicDecoct/decoctOper
住院清单汇总打印	api/query/printZYSF_ZYQDHZDY
送药登记	api/yf/regMedicDecoct/regDrugDelivery
住院电子发票综合操作-电子发票凭证信息	dataq/api/page/getZYWBFPXXByJZDH00
住院电子发票综合操作-住院病人结算发票信息	dataq/api/page/getZYJSFPXXByZYID00
电子票据换开纸质票据	api/ZYBSDZFPJKManager/turnPaper_ZY
住院收费_电子票据取票凭条(取票凭条打印)	print/api/query/printZYSFdzpjqppt
开具电子发票	api/ZYBSDZFPJKManager/invoiceEBill_ZY
电子票据冲红	api/ZYBSDZFPJKManager/writeOffEBill_ZY
下拉框字典-药房代煎标签药品名称（“标签”弹出框）	dataq/api/xdict
住院收费_纸质发票打印	print/api/query/printZYSFDZFPzzfpdy
获取有效纸质票据号段	api/ZYBSDZFPJKManager/getValidBillNo_XT
重新换开纸质票据	api/ZYBSDZFPJKManager/returnPaper_ZY
作废换开的纸质票据	api/ZYBSDZFPJKManager/invalidPaper_ZY
保存	api/yf/regMedicDecoct/save
获取员工系统权限	api/permissions
医保对应的同步对应	api/yk/CatalogMaintenanceService/setSynchronousCorrespondence
医保对应同步保存	api/yk/CatalogMaintenanceService/updateSaveSynchronously
送药标签(只对代签单查询有用)	api/yf/regMedicDecoct/getSYBQ
煎药表	api/yf/regMedicDecoct/getJYB
送药表	api/yf/regMedicDecoct/getSYB
标签按钮（弹出层，点“确认”）	api/yf/regMedicDecoct/getBQ
“代煎送药单” 打印	print/api/query/printZYDJSYD
过滤功能内容显示不全表头测试数据	dataq/api/header/filterContetTest
过滤功能内容显示不全表内容测试数据	dataq/api/page/filterContetTest
门诊电子发票综合操作-病人门诊结算信息	dataq/api/page/getMZJSFPXXByBRID
门诊电子发票综合操作-电子发票凭证信息	dataq/api/page/getMZWBPJXXByJZDH00
停用（启用）	api/yk/CatalogMaintenanceService/stopUse
药品信息保存	api/yk/CatalogMaintenanceService/preservationDrugInformation
获取药品树数据	api/yf/drugsTree/listDrugsTree
药品-类别（下拉框字典）	dataq/api/xdict?zdbm=10102
获取药品编码	api/yk/CatalogMaintenanceService/getYPBMFromYPJX
查询药品列表	dataq/api/page/listYplbForYFKCCX
获取查询药品列表前置条件（点击具体树节点触发）	api/yf/drugstockquery/getTreeViewClick
查询预扣库存信息	dataq/api/page/listYkkcxxForYFKCCX
“有效期修改”按钮-查询药品有效期历史修改记录	dataq/api/page/listYPYXQLSXGJL
“有效期修改”按钮-有效期修改	api/yf/drugstockquery/modifyValidDate
库存干预	api/yf/drugstockquery/interStock
删除本单预扣	api/yf/drugstockquery/delOrderWithhold
打印-物资批次库存	dataq/export/listYplbForYFKCCX
药品树结构-药品搜索	dataq/api/page/getDrugTreeSearch
查询隶属药品	api/yf/lsypwh/queryMedicInfo
全院药品信息	dataq/api/page/getHospwideDrugInfo
获取药品树列表明细	api/yf/drugsTree/getDrugsTreeMx
判断请领单是否存在	dataq/api/page/queryYFYPQLSQExist
请领单药品明细列表	dataq/api/page/queryYFYPQLSQYPXX
“有效期修改”按钮-加载有效期修改信息（药品入库明细信息）	api/yf/drugstockquery/getYprkmxForYxqxg
修改药品最大寄存数量	api/yf/medicineDistribution/updateMaxDrugDeposits
药理通用字典	dataq/api/page/YPBMWHYLDict
剂型通用字典	dataq/api/page/YPBMWHJXDict
药房麻醉药品管理获取病人树	api/yfNarcoticDrugs/getBRYPGLTree
药房-特殊药品-麻醉药品管理-药品明细	dataq/api/page/yfNarcoticDrugsMx
输入法-麻醉药品管理申请科室	dataq/api/page/getNarcoticDrugsApplyDeptDictList
输入法-麻醉药品管理申请医生	dataq/api/page/getNarcoticDrugsApplyUserDictList
输入法-麻醉药品管理-药品	dataq/api/page/getNarcoticDrugsDrugDictList
药房麻醉药品管理-保存病人麻醉药品	api/yfNarcoticDrugs/saveBRMZYP
药房麻醉药品管理-审核病人麻醉药品	api/yfNarcoticDrugs/auditBRMZYP
删除/注销病人麻醉药品	api/yfNarcoticDrugs/cancellationBRMZYP
审批病人麻醉药品	api/yfNarcoticDrugs/approvalBRMZYP
是否存在有效的麻醉卡号	api/yfNarcoticDrugs/isExistValidMZKH
输入法频次字典	dataq/api/page/getSRFpcZD
药品输入法字典	dataq/api/page/YFYPQLSQYPListDict
药房药品请领申请保存或修改	api/yf/drugApplication/yfBorrowDrugSaveOrUpdate
删除药房药品申领单	api/yf/drugApplication/yfBorrowDrugDelete
药库药品请领申请领药申请单	dataq/api/page/listYKYPQLSQD
添加所有配置台信息	api/yf/preparationTableDistribution/addAllMixingTableInformation
删除所有配置台信息	api/yf/preparationTableDistribution/deleteAllMixingTableInformation
药品字典（定位）	dataq/api/page/listYpDictForKCLXEWH
查询药品明细列表	dataq/api/page/listYpMxForKCLXEWH
获取申领单号	api/yf/drugApplication/getCKDH00
保存限额（修改）	api/yf/drugsStockLimit/saveLimitChange
获取住院摆药条件	dataq/api/page/getHospDrugDeliveryConditions
获取住院摆药条件属性	dataq/api/page/getHospDrugDeliveryConditionProp
打印	print/api/query/printYfYpkcxexx
获取住院摆药条件明细	dataq/api/page/getDrugDeliveryConditionDetail
操作住院摆药条件	api/yf/drugConditions/operateCondition
删除住院摆药条件	api/yf/drugConditions/deleteCondition
查询申请单明细	dataq/api/page/listYKYPQLSQDMX
领药药库字典	dataq/api/page/YKYPQLSQYKListDict
药库药品输入法字典	dataq/api/page/YKYPQLSQYPListDict
药库药品请领申请增加或修改单据	api/yf/drugApplication/ykBorrowDrugSaveOrUpdate
药库药品请领申请删除单据	api/yf/drugApplication/ykBorrowDrugDelete
分类下拉框字典	api/yf/drugstockwarn/listDrugsTypeDict
预警（查询库存预警药品列表）	dataq/api/page/listYfKcYJYPLBForKCYJ
药房下拉列表	dataq/api/xdict?zdbm=10107
转成请领单	api/yf/drugstockwarn/transToQLD
查询时间段内不同状态下盘点单树	api/yf/drugsTree/getPddState
查询药品盘点单	dataq/api/page/listYppddForYPPD
查询药品盘点单（已确认类型）	dataq/api/page/listYppddForYPPD2
查询药品盘点信息明细	dataq/api/page/listYppdxxmxForYPPD
保存	api/yf/yppd/save
打印药品别名	print/api/query/printXTYPBMWHPbmdy
查询盘点单生成列表【新开】	dataq/api/page/listPddscForYPPD
生成期初建账 / 生成盘点单【新开】	api/yf/yppd/scqcjz
删除、作废、退回、恢复	api/yf/yppd/operByType
增加药品	api/yf/yppd/addDrug
删除药品	api/yf/yppd/delDrug
药品定位	api/yf/yppd/ypdw
发送	api/yf/yppd/send
请求确认 / 确认	api/yf/yppd/configByType
盘点打印	api/yf/yppd/pddy
打印	api/yf/yppd/print
导出	api/yf/yppd/exportExcel
药房药品请领申请打印	print/api/query/printYFYPQLDdy
取消盘点状态	api/yf/qxpdzt/deal
获取科室及其勾选信息	dataq/api/page/listDepartmentAndCheckedInfo
查询过期或快过期药品清单列表	dataq/api/page/listYpgqOrKgqForYPPD
获取药品名称字典	ai/yf/dict/getYpzdList
药品类别字典	dataq/api/xdict?zdbm=10103
获取过期日期-截止日期	api/yf/xqgl/getInvalidateDate
打印	api/yf/xqgl/print
导出	api/yf/xqgl/export
科室输入法字典	dataq/api/page/listDepartmentSerch
药房药品请领申请切换单位	api/yf/drugApplication/getZHLandLSJ
病区退药开单科室结构树	api/yf/ReturnDrugBill/returnBillTree
获取住院摆药条件	dataq/api/page/queryZYBYTJDist
用户开单信息	dataq/api/page/queryYHXXCX
查看用户就诊卡信息	dataq/api/page/queryYHJZKXX
加载菜单更新通用字典	api/yf/prescriptionCheckBeforehand/serchTyzdOrAdd
确认按钮	api/yf/prescriptionCheckBeforehand/getCheckStatusAndSave
获取申请单号	api/yf/drugApplication/getYPQLDH
退药开单保存	api/yf/ReturnDrugBill/saveDrugBill
审方窗口	dataq/api/page/listAuditorWicket
病区退药开单查询下的科室结构树	api/yf/ReturnDrugBill/returnSearchBillTree
审方窗口状态	dataq/api/page/getAuditorWicketStatus
aaass	aaass
查询下的用户已退医嘱信息	dataq/api/page/queryYHYTYZXX
所选中出库明细“计价实发”发生变化，触发	api/yk/drugsOutWareConfirm/queryCKMXPCLYSLSetText
所选中出库明细“计量实发”发生变化，触发	api/yk/drugsOutWareConfirm/queryCKMXJLQLSLSetText
重制用户已退医嘱	api/yf/ReturnDrugBill/remakeDrugBill
交互服务当天数	api/jhScene
交互服务按月统计	api/jhSceneByM
交互服务按年统计	api/jhSceneByY
患者主索引数	api/jhIndex
患者主索引数按月查	api/jhIndexByM
确认窗口是否被其他电脑使用	api/yf/beforehandWindow/confirmWicket
打印用户已退医嘱明细（打印类型1）	print/api/query/printCZYHYTYZdy
事前审方窗口的刷新	dataq/api/page/listAuditorInfo
下拉框选择科室后的科室结构树	api/yf/ReturnDrugBill/returnChooseBillTree
病区退药开单下的选择科室字典	dataq/api/xdict?zdbm=10110
病区退药查询下的查询科室结构树	dataq/api/page/queryYPTYKDCXLCS
查看科室结构树下的用户信息	dataq/api/page/queryTYCXCKYHXX
审方操作的刷新	dataq/api/page/listAuditorOperationInfo
退回原因模板	dataq/api/page/listReasonTemplate
审核通过	api/yf/preCheckBeforehandWicket/clickApproved
事前审方窗口的处方退回	api/yf/preCheckBeforehandWicket/isCHUpdated
按病区查询科室结构树	api/yf/ReturnDrugBill/returnExcuteBillTree
按科室查询科室结构树	api/yf/ReturnDrugBill/returnExcuteRoomBillTree
查询用户退药信息	dataq/api/page/queryBQTYZZYHXX
病区退药执行确认	api/yf/ReturnDrugBill/returnExcuteBill
审方窗口下拉框	dataq/api/page/listAuditorWicket
人工审方状态	api/yf/preCheckBeforehandWicket/getISAUTO
点击人工审方复选框或者停止接单	api/yf/preCheckBeforehandWicket/clickIsAutoOrClickStop
保存原因	api/yf/preCheckBeforehandWicket/saveReason
审方操作-退回处方	api/yf/preCheckBeforehandWicket/prescriptionReturn
查询打印单子数量（打印类型1）	dataq/api/page/queryBQTYKDCXSL
打印用户已退医嘱明细（打印类型2）	print/api/query/printBQTYKDdy2
打印用户已退医嘱明细（打印类型3）	print/api/query/printBQTYKDdy3
事前审方窗口_中药（右边打印主信息）	dataq/api/page/listAuditorPrintInfo
事前审方窗口_中药（右边打印明细信息）	dataq/api/page/listDrugsPrintInfo
事前审方窗口的刷新	dataq/api/page/listAuditorInfo
审核通过	api/yf/preCheckBeforehandWicket/clickApproved
审方窗口下拉框	dataq/api/page/listAuditorWicket
人工审方状态	api/yf/preCheckBeforehandWicket/getISAUTO
根据摆药条件查询打印模板	dataq/api/page/queryGJBYTJCXDY
点击人工审方复选框或者停止接单	api/yf/preCheckBeforehandWicket/clickIsAutoOrClickStop
审方操作的刷新	dataq/api/page/listAuditorOperationInfo
退回原因模板	dataq/api/page/listReasonTemplate
保存原因	api/yf/preCheckBeforehandWicket/saveReason
审方操作-退回处方	api/yf/preCheckBeforehandWicket/prescriptionReturn
修改厂家批准文号	yk/blfp/modifyCJPZWH
审方记录查询-主表	dataq/api/page/listAuditorRecord
病区退药执行打印模板2	print/api/query/printBQTYZXdy2
病区退药执行打印模板3	print/api/query/printBQTYZXdy3
审方记录查询-明细	dataq/api/page/liseAuditorLogDetails
审方记录查询输入法-药品选择	dataq/api/page/listAuditDrugs
获取药品入库明细信息（“修改厂家批准文号”弹框之前调用）	api/yk/blfp/getYkYPRKMXInfo
医保项目编号输入法字典	dataq/api/page/getYBXMBHListDict
获取药品明细信息(在药品名称字典退出时候)	api/yk/rkdsr/getYpxxByYpmcDictExit
查询病人门诊流水记录	api/yf/query/queryOutpatientRecords
加载页面时获取页面展示样式参数	api/yf/query/getFormShowParam
查询流水记录详细药品信息	dataq/api/page/queryRecordsDrugDetailed
门诊流水转入库	api/yf/query/transferToWarehouse
保存处方点评	api/yf/qruey/savePrescriptionReviews
获取不合格原因	dataq/api/page/getDisqualificationReason
获取点评记录	dataq/api/page/getReviewRecords
病区退药开单下的根据卡号查询病人id	dataq/api/page/queryQBTYKDGJKHCXBR
打印门诊处方单	api/yf/qurey/prescription/printPrescription
审方	api/yf/query/prescription/review
打印药签	api/yf/qurey/prescription/printDrugSwab
全成分发送	api/yf/qurey/prescription/sendAllIngredients
打印门诊配药处方二维码	api/yf/qurey/prescription/printPrescriptionQRCode
生成评价表	api/yf/qurey/prescription/generateEvaluationForm
获取点评科室列表	dataq/api/page/getReviewsDept
其他接口参考门诊处方查询api	api/
未发药处方查询	dataq/api/page/queryUnissuedPrescription
处方明细查询	dataq/api/page/queryPrescriptionDetails 
发药（省人民无此功能）	api/yf/qurey/prescription/dispensingDrug
打印（省人民无此功能）	api/yf/qurey/prescription/print
门诊毒麻处方查询	dataq/api/page/queryMzToxicPrescription
毒麻处方药品明细	dataq/api/page/queryToxicPrescriptionDetail
打印毒麻处方	api/yf/qurey/prescription/printToxicPrescription
打印标签	print/api/query/printFYBQ2
明细信息修改	api/yf/qurey/mzToxic/save
毒麻处方记录查询	dataq/api/page/queryZyToxicPrescription
处方修改	api/yf/qurey/zyToxic/save
费别	dataq/api/page/getPaitentPayTypeList
病区退药执行下的查询代配退药打印张数	dataq/api/page/queryBQTYZXDPTYDYZS
